ABD = countries/Aberdeenshire.txt
ADR = countries/Adrianople.txt
AIS = countries/Artois.txt
ALN = countries/Alania.txt
AND = countries/Andalucia.txt
ANJ = countries/Anjou.txt
AZV = countries/Azov.txt
BJA = countries/Bjarmia.txt
BRS = countries/Brescia.txt
BYE = countries/Byelorussia.txt
CMB = countries/Cumberland.txt
DLM = countries/Dalmatia.txt
ESX = countries/Essex.txt
EST = countries/Estonia.txt
GIR = countries/Girona.txt
GRO = countries/Grodno.txt
ICE = countries/Iceland.txt
KHZ = countries/Khazaria.txt
LEO = countries/Leon.txt
LOT = countries/Lothian.txt
MCD = countries/Macedonia.txt
MCI = countries/Mercia.txt
MID = countries/Middlesex.txt
MIE = countries/Maine.txt
MRV = countries/Moravia.txt
PIE = countries/Piedmont.txt
SAP = countries/Sapmi.txt
SLO = countries/Slovakia.txt
SLV = countries/Slovenia.txt
THS = countries/Thessolonika.txt
THR = countries/Thrace.txt
TOL = countries/Toledo.txt
TRK = countries/Turkestan.txt
WSX = countries/Wessex.txt
YOR = countries/York.txt
ZEM = countries/Zemplen.txt
